6 8 8 6 6 7 8 8 6 6 8 6 8 7 6 6
6 0 1 2 0 0 0 0 0 0 0 2 2 0 0 0
8 0 0 0 0 0 1 0 0 1 0 0 0 0 1 1
8 1 0 0 0 0 2 5 5 5 2 0 2 0 0 0
8 2 0 1 0 2 3 4 5 5 0 0 1 2 0 0
7 0 0 0 2 5 5 5 4 3 5 0 1 0 0 0
6 0 0 2 1 5 5 3 4 5 5 0 0 0 0 0
6 2 0 0 0 0 1 5 5 5 5 0 0 0 0 2
8 1 0 2 2 0 0 1 2 0 0 0 2 0 0 1
8 0 0 0 1 0 0 1 0 2 0 1 2 0 0 0
7 0 1 0 0 0 0 0 0 0 0 0 0 0 0 2
6 0 2 0 0 1 1 2 1 2 0 0 0 0 1 2

