4 2 4 2 2 2 2 7 2 2 2 7 7 2 2 2 2 2 2 2 2 2 2 2 2 2 2 2 8 8 8 8 8 8 12 8 8 8 8 8 8 8 8 8 8 8 8 8 8 8 
4 4 4 4 7 10 10 10 6 6 6 13 13 10 11 13 10 10 10 13 13 14 14 9 8 8 12 12 12 8 12 8 8 12 8 8 8 8 8 8 8 8 8 8 8 8 8 8 8 8 
2 2 2 9 9 9 9 10 10 13 11 6 6 10 13 13 10 10 10 10 14 14 9 9 9 12 8 8 8 12 12 8 8 8 8 8 8 8 8 8 8 8 8 8 8 8 8 8 8 8 
2 2 9 9 9 9 9 9 10 13 6 11 10 6 6 10 10 10 10 10 14 14 9 9 9 8 8 8 8 12 8 8 8 8 8 8 8 8 8 8 8 8 8 8 8 8 8 8 8 8 
2 2 3 3 3 3 9 9 10 13 6 10 13 10 10 10 10 10 10 10 14 9 9 9 9 8 8 8 12 12 8 12 8 8 8 8 8 8 8 8 8 8 8 8 8 8 8 8 8 8 
2 2 1 1 5 3 9 9 10 10 10 10 6 10 10 10 10 10 10 10 14 9 9 9 9 8 8 12 8 12 12 12 8 12 8 8 8 8 8 8 8 8 8 8 8 8 8 8 8 8 
7 1 5 3 1 1 9 9 10 10 13 10 10 6 13 10 10 11 10 10 14 9 9 9 9 8 12 8 12 12 8 12 8 8 8 8 8 8 12 12 12 8 8 8 8 8 8 8 8 8 
2 5 1 1 3 5 9 9 10 10 10 6 13 10 10 10 10 10 10 10 14 9 9 9 9 12 8 8 8 8 8 8 12 8 12 12 8 8 12 12 12 12 12 12 12 12 12 12 12 12 
2 3 3 3 3 5 9 9 10 13 10 6 10 10 10 10 10 10 10 10 14 9 9 9 9 9 8 12 8 12 12 8 12 12 12 8 8 8 12 12 12 12 12 12 12 12 12 12 12 12 
2 1 1 5 1 9 9 9 10 10 11 6 13 13 6 13 10 10 10 11 14 9 9 9 9 9 8 8 8 12 8 8 8 12 8 8 12 8 12 12 12 12 12 12 12 12 12 12 12 12 
2 1 5 1 1 9 9 10 10 10 13 10 6 10 10 10 10 10 10 10 14 9 9 9 9 9 12 8 12 12 8 12 8 12 12 8 8 8 12 12 12 12 12 12 12 12 12 12 12 12 
2 3 1 5 5 9 10 10 13 6 10 10 14 10 10 10 10 10 10 10 14 9 9 9 9 9 8 8 12 8 12 8 8 8 8 8 8 12 12 12 12 12 12 12 12 12 12 12 12 12 
2 9 9 9 9 9 10 10 6 6 10 11 10 6 11 10 10 6 6 10 14 9 9 9 9 9 12 8 8 12 8 8 12 8 12 12 12 8 12 12 12 12 12 12 12 12 12 12 12 12 
2 9 9 9 9 10 13 10 13 10 10 11 14 14 11 10 6 10 6 10 14 14 9 9 9 9 8 12 12 8 12 12 8 12 8 12 8 8 8 8 8 8 8 8 8 8 8 8 8 8 
2 10 10 13 13 10 10 10 10 10 6 11 14 14 11 10 10 10 10 10 10 14 9 9 9 9 8 12 8 8 12 8 8 8 12 8 8 12 8 8 8 8 8 8 8 8 8 8 8 8 
2 10 10 10 13 13 6 10 10 10 6 11 14 14 11 10 10 10 10 10 10 14 14 9 9 9 9 9 12 12 8 8 12 8 8 8 8 8 8 8 8 8 8 8 8 8 8 8 8 8 
2 10 10 6 10 10 10 6 13 11 11 11 14 14 11 11 11 11 11 11 10 10 14 14 14 9 9 9 9 9 9 9 9 9 9 9 9 9 9 9 9 9 9 9 9 9 9 9 2 2 
2 10 6 10 10 10 11 11 11 11 14 14 14 14 14 14 14 14 14 11 11 10 10 10 14 14 9 9 9 9 9 9 9 9 9 9 9 9 9 9 9 9 9 9 9 9 9 2 2 2 
7 10 6 10 11 11 11 14 14 14 14 14 14 14 14 14 14 14 14 14 11 11 11 10 10 10 10 10 10 10 10 10 10 10 10 10 10 10 10 10 10 10 10 10 10 10 10 2 4 2 
2 6 6 11 11 14 14 14 14 14 14 11 11 11 11 11 11 11 14 14 14 14 11 11 10 10 10 10 10 10 10 10 10 10 10 10 10 10 10 10 10 10 10 10 10 10 10 2 2 2 
4 10 11 11 14 14 14 14 14 14 11 11 14 14 14 14 14 11 11 11 14 14 14 11 10 10 10 10 10 10 10 10 10 10 10 10 10 10 10 10 10 10 10 10 10 10 10 10 2 2 
7 11 11 14 14 14 14 14 14 11 11 11 14 14 14 14 14 14 14 11 11 11 14 11 10 10 10 10 10 10 10 10 10 10 10 10 10 10 10 10 10 10 10 10 10 10 10 10 2 2 
2 11 14 14 14 14 14 14 14 14 14 11 11 14 14 14 14 14 14 14 14 11 14 11 10 10 10 10 10 10 10 10 10 10 10 10 10 10 10 10 10 10 10 10 10 10 10 10 10 2 
2 11 11 14 14 14 14 14 14 14 14 14 11 11 14 14 14 14 14 14 14 11 14 11 11 11 11 11 11 11 11 11 10 10 10 10 10 10 10 10 10 10 10 10 10 10 10 10 10 2 
4 11 11 11 11 14 14 14 14 14 14 14 14 11 11 11 11 11 14 14 14 11 14 14 14 14 14 14 14 14 14 11 11 10 10 10 10 10 10 10 10 10 10 10 10 10 10 10 10 2 
4 10 10 11 11 11 11 11 11 11 11 14 14 14 14 14 14 11 11 14 14 11 11 11 14 14 14 14 14 14 14 14 11 11 10 10 10 10 10 10 10 10 10 10 10 10 10 10 10 2 
2 10 10 10 10 10 10 10 10 10 11 11 14 14 14 14 14 14 11 14 14 14 11 11 11 11 11 11 11 11 11 14 14 11 11 10 10 10 10 10 10 10 10 10 10 10 10 10 10 2 
4 10 10 10 10 10 10 10 10 10 10 11 14 14 14 14 14 14 14 14 14 14 14 14 14 14 11 14 14 14 11 14 14 11 11 11 10 10 10 10 10 10 10 10 10 10 10 10 10 4 
4 10 10 10 10 10 10 10 10 10 10 11 11 14 14 14 14 14 14 14 14 14 14 14 14 11 14 14 14 14 11 14 14 14 11 11 11 11 11 11 11 11 11 10 10 10 10 10 10 2 
7 10 10 10 10 10 10 10 10 10 10 10 11 11 14 14 14 14 14 14 14 14 14 14 14 11 14 14 14 11 11 14 14 14 14 14 14 14 14 14 14 14 11 11 10 10 10 10 10 2 
4 10 10 10 10 10 10 10 10 10 10 10 10 11 11 11 14 14 14 14 14 14 14 14 14 14 14 14 11 11 14 14 11 14 14 14 14 14 14 14 14 14 14 11 10 10 10 10 2 2 
4 10 10 10 10 10 10 10 10 10 10 10 10 10 10 11 14 14 14 14 14 14 14 11 11 11 11 11 11 14 14 14 11 11 14 14 14 14 14 14 14 14 14 11 10 10 10 2 2 2 
4 10 10 10 10 10 10 10 10 10 10 10 10 10 10 11 14 14 14 14 14 11 11 11 10 10 10 10 14 14 14 14 11 11 14 14 14 14 14 14 14 14 14 11 11 10 2 2 2 2 
10 10 10 10 10 10 10 10 10 10 10 10 10 10 11 11 14 14 14 14 11 11 10 10 10 10 10 10 10 10 10 14 11 11 14 14 14 14 14 14 14 9 9 11 11 11 11 11 11 2 
10 10 10 10 10 10 10 10 10 10 10 10 10 11 14 14 14 14 14 11 11 10 10 10 10 10 10 10 10 10 10 10 11 11 14 14 14 9 9 9 9 9 9 3 3 3 3 3 3 2 
10 10 10 10 10 10 10 10 10 10 10 11 11 11 14 14 14 14 11 11 10 10 10 10 10 10 10 10 10 10 11 11 11 9 9 9 9 9 9 9 9 9 3 3 3 3 1 3 3 2 
7 10 10 10 10 10 10 10 10 11 11 11 14 14 14 14 14 14 11 10 10 10 10 10 10 10 10 10 10 11 11 13 11 9 9 9 9 9 9 3 3 3 3 1 3 1 3 3 3 2 
4 10 10 10 4 4 10 10 11 11 11 11 14 14 14 14 14 11 11 10 10 10 10 10 10 10 10 10 11 11 13 13 11 9 9 9 9 9 3 3 3 3 3 3 3 3 3 1 3 2 
4 4 10 10 4 4 4 4 10 14 10 10 10 10 14 14 14 11 10 10 10 10 10 10 10 10 10 10 11 13 10 10 11 9 9 9 9 3 3 5 3 3 5 1 3 3 3 5 5 2 
4 4 14 14 14 14 14 14 4 6 6 6 10 6 10 10 11 11 10 10 10 10 10 10 10 10 10 11 11 10 10 13 11 9 9 3 3 3 5 3 5 3 5 3 5 3 3 3 3 2 
7 4 4 14 14 14 14 14 10 10 6 10 10 10 10 11 11 10 10 10 10 10 10 10 10 10 10 11 10 10 10 13 11 9 1 3 5 3 5 1 3 3 3 3 3 3 3 1 3 2 
4 2 4 4 4 4 4 7 2 4 4 4 2 4 11 11 10 6 10 14 6 6 10 10 10 10 10 10 10 10 10 11 11 9 1 3 3 5 3 3 3 3 5 1 3 3 3 3 3 2 
4 2 4 4 7 4 4 4 2 7 7 2 4 4 4 6 10 6 10 6 10 10 10 10 10 10 10 10 10 10 10 11 9 9 1 5 3 3 3 5 3 3 3 3 5 3 1 3 3 2 
2 2 7 4 4 7 4 7 14 14 14 14 14 14 4 4 6 14 6 6 6 6 10 10 10 10 10 10 10 10 10 11 9 9 3 5 3 3 1 3 1 3 3 3 3 3 3 3 3 2 
4 2 4 2 2 2 7 14 14 14 14 14 14 14 14 14 14 14 6 14 10 10 10 10 10 10 10 10 10 10 10 11 9 3 3 5 3 3 3 3 3 3 1 3 3 3 3 3 9 2 
2 2 7 7 2 2 7 14 14 14 14 14 14 14 14 14 14 14 10 6 10 10 6 10 10 10 10 10 10 10 10 11 9 3 1 3 3 3 1 3 3 3 3 3 3 3 3 9 9 2 
4 4 7 7 2 7 14 14 14 14 14 14 14 14 14 14 14 14 4 10 10 10 10 10 10 10 10 10 10 10 11 11 9 9 1 5 3 3 3 1 5 3 1 3 3 5 9 9 9 2 
4 2 7 2 7 2 14 14 14 14 14 14 14 14 14 14 4 4 2 4 10 10 10 10 10 10 10 10 10 11 11 9 9 9 1 3 1 5 5 3 3 3 3 9 9 9 9 9 9 2 
7 4 2 4 2 7 4 7 14 14 14 14 14 14 14 14 4 4 2 4 4 10 10 10 10 10 10 10 11 11 11 9 9 9 9 9 3 3 3 3 3 3 9 9 9 9 9 9 2 2 
2 7 4 4 2 2 2 4 7 7 7 4 4 4 7 4 4 4 2 2 4 4 4 7 4 2 7 2 2 4 4 4 2 2 2 2 2 2 2 2 2 2 2 2 2 2 2 2 2 2 
